food=10
sn1x=15
sn1y=10
sn1L=5
sn1D=0
sn2x=1
sn2y=18
sn2L=5
sn2D=1
111111111111111111111111111111
100000000000001100000000000001
100010000000001100000000010001
100110000000001100000000011001
101110000000000000000000011101
100000000000000000000000000001
100000000000111111000000000001
100000000000100001000000000001
100000000000100001000000000001
100000000000001100000000000001
100000000000000000000000000001
100000000000100001000000000001
100000000000111111000000000001
100000000000000000000000000001
100000000000000000000000000001
101110000000000000000000011101
100110000000001100000000011001
100010000000001100000000010001
100000000000001100000000000001
111111111111111111111111111111
