food=15
sn1x=20
sn1y=2
sn1L=5
sn1D=0
sn2x=1
sn2y=18
sn2L=5
sn2D=1
111111111111111111111111111111
100000000000000000000000000001
100000000000000000000000000001
100111111111100001111111111001
100100000000000000000000001001
100100000000000000000000001001
100100000000000000000000001001
100100001001111111100100001001
100000001000000000000100000001
100000001000000000000100000001
100000001000000000000100000001
100000001000000000000100000001
100100001001111111100100001001
100100000000000000000000001001
100100000000000000000000001001
100100000000000000000000001001
100111111111100001111111111001
100000000000000000000000000001
100000000000000000000000000001
111111111111111111111111111111
