food=15
sn1x=20
sn1y=2
sn1L=5
sn1D=0
sn2x=1
sn2y=18
sn2L=5
sn2D=1
111111111111111111111111111111
100000000000000000000000000001
100000000000000000000000000001
100000000000000000000000000001
100011111111100111111111110001
100010000000000000000000010001
100010000000000000000000010001
100010000000000000000000010001
100010001111100111111100010001
100010000000000000000100010001
100010000000000000000100010001
100011111111100111111100010001
100000000000000000000000010001
100000000000000000000000010001
100000000000000000000000010001
111111111111100111111111110001
100000000000000000000000000001
100000000000000000000000000001
100000000000000000000000000001
111111111111111111111111111111
